....................
....................
....................
...........#####....
......######........
......#.............
......#.............
....................
...............##...
...............####.
......#.............
......#.............
......#.............
......#.............
......#######.......